NO tests/spr1.xpm
SO tests/spr2.xpm
WE tests/spr3.xpm
EA tests/spr4.xpm

F 255,255,0
C 127,0,0

111111
100001
101001
1100N1
111111
  111111
  100001
  101001
  1100N1
  111111