NO assets/sprites/dark_north.xpm
SO assets/sprites/dark_south.xpm
EA assets/sprites/dark_east.xpm
WE assets/sprites/dark_west.xpm

F 4,5,4
C 6,7,6

1111
1001
1101
 101
 101
 101
 101
 101
 101
 101
 101
 101
 101
 101
 101
 101
 101
 1N1
 111