NO assets/textures/severence/only_wall.xpm
SO assets/textures/severence/only_wall.xpm
WE assets/textures/severence/only_wall.xpm
EA assets/textures/severence/only_wall.xpm

F 64,109,78
C 212,224,224


  11111111111
  10000000001
  10111111101
  101     101
  101     101
  11111111101
  10000000001
  11111011111
      101        
111111101111
100100000001
100100000001
100000000001
10010000000111
1001000N000001
11111111111111