NO assets/textures/severence/north_wall.xpm
SO assets/textures/severence/south_wall.xpm
WE assets/textures/severence/west_wall.xpm
EA assets/textures/severence/east_wall.xpm

F 231,238,234
C 231,238,234

1111111111111111111
1000000000000000001
1011111110111011101
101     101 101 101
101     101 101 101
101     101 111 101
101     101     101
1011111 101     101
1000001 101     101
1011111 101     101
101     101     101
101     101 1111101
101     1N1 1000001
111     111 1111111